NO ./assets/textures/greystone.xpm
SO ./assets/textures/pinkstone.xpm
WE ./assets/textures/redbrick.xpm
EA ./assets/textures/wood.xpm

F 3035,707,257
C 252,254,256





11111111
10010001
10000001
1100N001
10010001
10000001
10010001
10000001
111111111
