NO ./assets/textures/greystone.xpm
SO ./assets/textures/pinkstone.xpm
WE ./assets/textures/redbrick.xpm
EA ./assets/textures/wood.xpm

F 77,92,53
C 163,208,230








111111

1  00101
101001
1100N1
111111

//cant have anything below map too, map should be the last
Ba 123,123,123
