
NO ./assets/textures/marcus/m1.xpm

SO ./assets/textures/marcus/m12.xpm

WE ./assets/textures/marcus/m123.xpm

EA ./assets/textures/marcus/m1234.xpm

F 77,92,53
C 163,208,230

 1111
10000
101101
101001
1S0001
 1111
