
NO ./assets/textures/greystone.xpm

SO ./assets/textures/pinkstone.xpm

WE ./assets/textures/redbrick.xpm

EA ./assets/textures/wood.xpm

F 77,92,53
C 163,208,230





111111111100111111111111
111111111100111111111111
1N0000000000000000000001
110000000000000000000001
1100000000000000N0000001
110000000000000000000001111111111111111111111111
11000000000000000000000000 000000000000000000111
110000000000000000000001100 00000000000000001101
1111111101111111111111111000 0000000000111111001
       101              10000   00000001   11001
       101               1000   00000001   1101
       101              110000000000000111111111
       101                11110000000000001111
       101                   10001111110001  
       101                   11001    10011  
       101                    1111    1111 
