
NO ./assets/textures/seb/seb.xpm

SO ./assets/textures/seb/seb1.xpm

WE ./assets/textures/seb/seb2.xpm

EA ./assets/textures/seb/seb3.xpm

F 77,92,53
C 163,208,230





111111111111111111111111
100100000001000000000001
100000000001000000000001
11100N000001100000000001
111000000001111100110001
111000000000000000000001111111111111111111111111
111000000000000000000000000100000000000000000111
111000000001000000000001100100000000000000001101
111111111111111111111111100100000000000111111001
                        10010   00000001   11001
                         1010   00000001   1101
                         1000000000000011111111
                          11110000000000001111
                             10001111110001
                             11001    10011
                              1111    1111
