NO ./assets/textures/marcus/m1.xpm
SO ./assets/textures/marcus/m12.xpm
WE ./assets/textures/marcus/m123.xpm
EA ./assets/textures/marcus/m1234.xpm

F 5555,123123,512412424
C 124142343,22348,20












11111111111111111111111111111111111111111111111
11011111111111111111111111111111111111111111111
1000                                         01
11011111111111111111111111111111111111111111 11
11111111111111111111111111111111111111111111 11
11111111111111111111111111111111111111111111 11
11111111111111111111111111111111111111111111 11
11111111111111111111111111111111111111111111 11
11111111111111111111111111111111111111111111 11
11111111111111111111111111111111111111111111 11
11111111111111111111111111111111111111111111 11
11111111111111111111111111111111111111111111 11
11111111111111111111111111111111111111111111 11
11111111111111111111111111111111111111111111 11
10000000000000000000000000000000000000000010001
10000000000000000000000000000000000000000010001
10000000000000000000000000000000000000000010001
10000000000000000000000000000000000000000010001
10000000000000000000000000000000000000000010001
10000000000000000000000000000000000000000011001
1E000000000000000000000000000000000000000000001
11111111111111111111111111111111111111111111111
