NO ./assets/textures/test/greystone.xpm
SO ./assets/textures/test/pinkstone.xpm
WE ./assets/textures/test/redbrick.xpm
EA ./assets/textures/test/wood.xpm

F 3035,707,257
C 252,254,256





11111111
10000001
10000001
1000S001
10000001
10000001
10000001
10000001
111111111
