
NO ./assets/textures/greystone.xpm

SO ./assets/textures/pinkstone.xpm

WE ./assets/textures/redbrick.xpm

EA ./assets/textures/wood.xpm

F 77,92,53
C 163,208,230





111111111111111111111111
100100000100000000000001
100000000000000000000001
11000W000001100000000001
110000000001100000000001
110000000000000000000001111111111111111111111111
11000000000000000000000000 000000000000000000111
110000000000000000000001100 00000000000000001101
1111111111111111111111111000 0000000000111111001
                        10000   00000001   11001
                         1000   00000001   1101
                         1000000000000011111111
                          11110000000000001111
                             10001111110001
                             11001    10011
                              1111    1111
