NO ./assets/textures/greystone.xpm
SO ./assets/textures/pinkstone.xpm
WE ./assets/textures/redbrick.xpm
EA ./assets/textures/wood.xpm

F 77,92,53
C 163,208,230





11111111
10001001
10000001
10000001
1000N001
10000001
10000001
10000001
111111111
