
NO ./assets/textures/marcus/m1.xpm

SO ./assets/textures/marcus/m12.xpm

WE ./assets/textures/marcus/m123.xpm

EA ./assets/textures/marcus/m1234.xpm

F 77,92,53
C 163,208,230

 1111
100001
100001
110101
1S0101
 1111
