NO ./assets/textures/greystone.xpm
SO ./assets/textures/pinkstone.xpm
WE ./assets/textures/redbrick.xpm
EA ./assets/textures/wood.xpm

F 77,92,53
C 163,208,230





11111111
10010001
10000001
1100N001
10010001
10000001
10010001
10000001
11111111
